NO texture3.xpm
SO texture4.xpm
WE texture.xpm
EA texture2.xpm

C 225,30,0

111111111111111111
100000000000000001
100000000111100001
100000000001100001
10000000N001100001
100000000001100001
100000000000100001
111111111111111111