NO ./textures/texture_red.xpm
SO ./textures/texture_green.xpm
WE ./textures/texture_orange.xpm
EA ./textures/texture_purple.xpm

F 128,128,128

C 135, 206 ,235

111111111111111111111111111111111111111111111111111111
100000000000000000000000000000000000000000000000000001
100000000000000000000000000000000000000000000000000001
100000000000000000000000000000000000010000000000000001
1000000000000000N0000000000000000000010000000000000001
100000000000000000000000000000000000010000000000000001
100000000000000000000000000000000000010000000000000001
100000000000000000000000000000000000000000000000000001
100000000000000000000000000000000000000000000000000001
100000000000000000000011111100000000000000000000000001
111111111111111111111111111111111111111111111111111111