NO ./textures/texture_red.xpm
SO ./textures/texture_green.xpm
WE ./textures/texture_orange.xpm
EA ./textures/texture_purple.xpm

F 148,0,211

C 135,206,235

111111111111
100000000001
10000N000001
100000000001
100000000001
111111111111