NO texture3.xpm
SO texture4.xpm
WE texture.xpm
EA texture2.xpm

F 220,100,0
C 225,30,0

1111111111111111111
1000000000001000001
1000000000000100001
100000000N001000001
1000000000010000001
1111111111111111111