NO texture_red.xpm
SO texture_green.xpm
WE texture_orange.xpm
EA texture_purple.xpm

F 128,128,128

C 135, 206 ,235

111111111111111111
100000000000000001
100000000001100001
100000000001100001
10000000N001100001
100000000001100001
100000000000100001
111111111111111111