NO ./textures/texture3.xpm
SO ./textures/texture4.xpm
WE ./textures/texture.xpm
EA ./textures/texture2.xpm

F 220,100,0
C 225,30,0

111111111111111111111111111111111111111111111
100000000000000010000000001000000000000000111
100000000000000010000000001000000000000000111
100000000000000011000000011000000000000000001
10000000N000000000000000000000000000000000001
100000000000000000000000000000000000000000001
100000000000000000000000000000000000000000001
111111111111111111111111111111111111111111111